107
8
22 4 0 0 0 0 0 0 0 0 0 0 0 0 0 0 0 0 0 0 0 0 0 0 0 0 0 0 0 0 0 0 21 21 21 21 21 21 21 21 21 21 21 21 21 0 0 0 0 0 0 0 0 0 0 0 0 0 0 0 0 0 0 0 0 0 0 0 0 0 0 0 0 0 0 0 0 0 0 0 0 0 0 0 0 22 0 0 0 0 0 0 0 0 0 0 0 0 0 0 0 0 0 0 0 22 22 
22 4 0 0 0 0 0 0 0 0 0 0 0 0 0 0 0 0 0 0 0 0 0 0 0 0 0 0 0 0 0 0 21 0 0 0 0 0 0 0 0 0 0 0 21 0 0 0 0 0 0 0 0 0 0 0 0 0 0 0 0 0 0 0 0 0 0 0 0 0 0 0 0 0 0 0 0 0 0 0 0 0 0 0 0 0 0 0 0 0 0 0 0 0 0 0 0 0 0 0 0 0 0 0 0 22 22 
22 4 0 0 0 0 0 0 0 0 0 0 0 0 0 0 0 0 0 0 0 0 0 0 0 0 0 0 0 0 0 0 21 0 0 0 0 0 0 0 0 0 0 0 0 0 0 0 0 0 0 0 0 0 0 0 0 0 0 0 0 0 0 0 0 0 0 0 0 0 0 0 0 0 0 0 0 0 0 0 0 0 0 0 0 22 0 0 0 0 0 0 0 0 0 10 0 0 0 15 16 0 0 0 0 22 22 
22 4 0 0 0 0 0 0 0 0 0 0 0 0 0 0 0 0 0 0 0 0 0 0 0 0 0 0 0 0 0 0 21 0 0 0 0 21 0 0 0 0 0 0 21 0 0 0 0 0 0 0 0 0 0 0 0 0 0 0 0 0 10 0 11 0 0 0 0 0 0 0 0 0 0 0 0 0 0 0 0 0 0 0 0 22 0 0 0 0 0 0 0 0 22 22 0 0 0 0 0 0 0 0 0 22 22 
22 4 0 0 0 0 23 24 25 0 0 0 0 0 0 21 21 0 0 0 23 24 25 0 0 0 0 0 0 0 21 0 21 0 0 0 0 21 21 0 0 0 0 0 21 21 21 21 0 0 0 0 21 0 0 0 21 0 0 0 1 21 21 21 21 2 0 0 0 0 0 0 0 0 0 0 0 0 0 23 24 25 0 0 0 22 0 0 0 0 0 0 0 22 22 22 0 0 0 0 0 0 0 0 0 22 22 
22 4 0 0 0 0 0 0 0 0 0 0 0 0 0 21 21 0 0 0 0 0 0 0 0 0 0 0 0 0 21 0 0 0 0 21 0 21 21 0 0 0 0 0 21 21 21 21 0 0 0 0 21 0 0 0 21 0 0 0 3 21 22 22 22 4 0 0 0 0 0 0 0 0 0 0 0 0 0 0 0 0 0 0 0 22 0 0 0 0 0 11 22 22 22 22 0 0 0 0 0 0 0 0 0 22 22 
22 4 0 0 21 0 0 0 0 0 0 0 0 0 0 21 21 21 0 0 0 0 0 0 0 0 0 0 0 0 21 0 0 0 0 0 0 0 0 0 0 0 0 0 22 22 22 22 0 0 0 0 21 0 0 0 21 0 0 10 1 21 22 22 22 4 0 0 0 0 0 0 0 10 0 0 21 0 0 0 0 0 0 11 0 22 0 0 0 0 0 22 22 22 22 22 0 0 0 10 11 0 0 0 0 22 22 
22 21 21 21 21 21 21 21 21 21 21 21 22 22 22 22 21 21 21 21 21 22 22 22 22 21 21 21 21 21 21 21 21 21 21 21 21 22 21 21 21 21 21 21 22 22 22 21 21 21 21 21 21 21 21 21 21 21 21 21 21 21 22 22 22 21 21 21 21 21 21 21 21 21 21 21 21 21 21 21 21 21 21 21 21 22 21 21 21 22 22 21 21 21 21 21 21 21 21 21 21 21 21 21 21 21 21 
